R 600 1000
NO ./texture/violet.xpm
SO ./texture/pink.xpm
WE ./texture/wallgray3.xpm
EA ./texture/wallgray2.xpm
S ./texture/collumn.xpm

F 255,204,204
C 153,255,255

11111111111111111111111111
111111111111111111111111
10000000000000000000000S1
11111110000000000000011111111
       100020000011111010000111111
1111111100000000000000000011111111
1000000000000100010100001101
100000000101010100000111111
111111001101110010000000011
100010011001000000001111111
111111001111111110000000011
10000000000000000000000011
11111111111111111111111111

