R 10 -1000
NO ./texture/violet.xpm
SO ./texture/pink.xpm
WE ./texture/wallgray3.xpm
EA ./texture/wallgray2.xpm
S ./texture/collumn.xpm

F 255,204,204
C 153,255,255

1111111111111111111111111
10000000000000000000000S1
1002000001111101000011111
100000000100010100001
1000000001010101000011111
1111110001011101000000001
100010000010000000011111
1111110001111111000000001
1000000000000000000000001
1111111111111111111111111
