R 2000 1000
NO ./texture/violet.xpm
SO ./texture/pink.xpm
WE ./texture/wallgray3.xpm
EA ./texture/wallgray2.xpm
S ./texture/collumn.xpm

F 255,204,204
C 153,255,255

111111
110001
1S11S1
1111
111111
